###############
Sa##lzxyhjklklc
#bacd##########
#q#############
#rst###########
###u###########
#xwv###########
#y#############
#znomabctwuswme
#a#############
#biftsatymcaxym
###########z###
###############
###############
###############